NO ./textures/north.xpm
SO ./textures/south.xpm
WE ./textures/east.xpm
EA ./textures/west

C 200,200,200
F   225,30,01

  111111111 111
11   100001 101111
     10000111011 11
 11 11011000001
  110000011111111011
    100N00001      11
     111001011111111
     1000010000011
      1110001111
         1011
    11   11   1 
     111111111