NO abcdefg
SO 
   
1111
1Nn1
1111
