NO ./maps/simple.cub

C 1,3,3
F 4,5,6

1111
1 W1
1111



b


a



hola
