NO abcdefg
C 1,3,3
F 4

1111
1 W1
1111
