NO ./textures/north.xpm
SO ./textures/south.xpm
EA ./textures/east.xpm
WE ./textures/west.xpm

C 1,3,3
F 4,5,6

1111
10W1
1111

