NO 
SO 
   

  1111
1001
1111


