NO 
SO 
   
 1111
10011
1111


