NO abcdefg
SO 
   
1111
1 W1
1111
