NO ./textures/color_stone.xpm
SO ./textures/purple_stone.xpm
EA ./textures/grey_stone.xpm
WE ./textures/blue_stone.xpm

C 135,206,235
F 139,69,19

11111111
100000N1
10111101
10100101
10111101
10000001
11111111