NO ./textures/color_stone.xpm
SO ./textures/purple_stone.xpm
EA ./textures/grey_stone.xpm
WE ./textures/blue_stone.xpm

C 135,206,235
F 139,69,19

11111111111111111111
10000000000000000001
10000000000000000001
100000000N0000000001
10000000000000000001
10000001111110000001
10000001000010000001
10000001000010000001
10000001000010000001
10000001111110000001
10000000000000000001
10000000000000000001
10000000000000000001
10000000000000000001
11111111111111111111