NO ./textures/north.xpm
SO ./textures/south.xpm
WE ./textures/east.xpm
EA ./textures/west

C 200,200,200
F   225,30,01

111111 111
1    1 1 1
1    111 1
1        1
1      111
1 N    1
111    11111
  1        1
  111  11111
    1111