NO ./textures/color_stone.xpm
SO ./textures/purple_stone.xpm
EA ./textures/grey_stone.xpm
WE ./textures/blue_stone.xpm

C 135,206,235
F 139,69,19

11111
10001
10N01
10001
11111


