NO ./textures/color_stone.xpm
SO ./textures/purple_stone.xpm
EA ./textures/grey_stone.xpm
WE ./textures/blue_stone.xpm

C 135,206,235
F 139,69,19

        1111111111 11111111111111
        1000000001 10000000000001
        1011000001110000000000E01
        1001000000000000000000001
111111111011000001110000000000001
100000000011000001110111111111111
11110111111111111100000000001
  1101           101010010001
111001           100000010001
10000111111111111100000010001
10000000000000000001010010001
1100000111010101111101111000111
11110111 1110101 101111010001
11111111 1111111 111111111111