
NO ./textures/color_stone.xpm
SO ./textures/purple_stone.xpm
EA ./textures/grey_stone.xpm

C 255,255,255
WE ./textures/blue_stone.xpm

F 255,0,0

        
        111111111111111111111111
        10000000001100000000000W1
        1011000001110000000000001
        1001000000000000000000001
111111110011000001110000000000001
100000000011000001110111111111111
11110111111111011100000000001
11110111111111011101010010001
11000000110101011100000010001
10000000000000001100000010001
10000000000000001101010010001
1100000111010101111101111000111
11110111 1110101 101111010001
11111111 1111111 111111111111
1
1
1
