                   NO ./textures/color_stone.xpm
 SO ./textures/blue_stone.xpm
   EA ./textures/grey_stone.xpm


 C 		200,200,200
F   225,	30,  01
         	WE ./textures/purple_stone.xpm
        111111111111111111111111
        1000000000110000000000001
        1011000001110000000000001
        10010000000000000000000E1
111111110011000001110000000000001
100000000011000001110111111111111
11110111111111011100000000001
11110111111111011101010010001
11000000110101011100000010001
10000000000000001100000010001
10000000000000001101010010001
1100000111010101111101111000111
11110111 1110101 101111010001
11111111 1111111 111111111111
