NO ./path_to_the_north_texture
SO ./path_to_the_south_texture
WE ./path_to_the_west_texture
EA ./path_to_the_east_texture

F 220,100,0
C 225,30,0


10111111111111111111111111
11000000000110000000000001
12011000001110000000000001
13001000000000000000000001
1411111111011000001110000000000001
150000000011000001110111111111111
16110111111111011100000010001
17110111111111011101010010001
18000000110101011100000010001
19000000000000001100000010001
12000000000000000i01101010010001
121000001110101011111011110N0111
1221110111 1110101 101111010001
1231111111 1111111 111111111111


