NO ./textures/north.xpm
SO ./textures/south.xpm
WE ./textures/east.xpm
EA ./textures/west.xpm

C 200,200,200
F   225,30,01

        1111111111111111111111111
        1000000000110000000000001
        1011000001110000000000001
        100100000	0000000000001
111111111011000001110000000000001
100000000011000001110111111111111
11110111111111011100000010001
11110111111111011101010010001
1100000011010101110000001 	1
100		 000000011000000100 1
10000000000000001101010000001
11000001110101011111011110N0111
11110111 1110101 101111010001
11111111 1111111 111111111111