NO ./textures/color_stone.xpm
SO ./textures/purple_stone.xpm
EA ./textures/grey_stone.xpm
WE ./textures/blue_stone.xpm

C 135,206,235
F 139,69,19

1S111
10001
10001
10001
10001
10001
11001
10001
10001
10001
10001
10001
11111
